10,10
##########
#  bB    #
#   #    #
#   #    #
#  ####  #
#   #   @#
#  ####  #
#   #    #
#  rR    #
##########
3,5,START
5,5,SMARTENEMY