20,15
####################
#@        #       t#
#         #        #
#   ####  #        #
#         #        #
#         #t      t#
#WW############ ####
#w                 #
# #########        #
#         #        #
#         #        #
#  #####  #        #
#         #        #
#                  #
####################
11,1,START
1,3,WALLENEMY
3,3,WALLENEMY
10,7,TOKENDOOR,3
2,11,WALLENEMY