10,10
##########
##  #  ###
#   #   ##
#        #
#   #    #
#   #  ###
#   #    #
##       #
###     ##
##########
1,2,START
2,5,SMARTENEMY