15,15
###############
#  WWR  #######
# ##W## #######
####t##@#######
###############
###############
###############
# #############
#      FFFFFFw#
###### ########
#f            #
############# #
#r            #
###############
###############
1,1,START
1,2,TELEPORTER,1,7
1,7,TELEPORTER,1,2
7,10,TOKENDOOR,1