10,10
##########
# ########
# #ttG#t##
# ###tBt##
# ###R#Y##
#        #
# ########
# #yrbg###
#       @#
##########
1,1,START
7,8,TOKENDOOR,5