15,14
###############
#           R@#
#           ###
##B###        #
#    #        #
#    #        #
#    #        #
#    #    r   #
#    ####   ###
#    # wW   WW#
#    ####   #W#
#            W#
#b           W#
###############
6,9,START
6,7,SMARTENEMY
13,7,SMARTENEMY