15,14
###############
#WWWWWWW    R@#
#WWWWWWW    ###
#B####WW      #
#    #WW      #
#    #        #
#    #    r   #
#    #        #
#    ####   ###
#    # wW   WW#
#    ####   #W#
# b          W#
#            W#
###############
6,9,START
8,7,DUMBENEMY
11,7,SMARTENEMY