10,10
##########
# IIIIIII#
#I       #
#I       #
#I       #
#I       #
#I       #
#I       #
#I       #
##########
1,1,START