15,15
###############
#t#          f#
#t#           #
#W#           #
#            w#
#      ########
#      #      #
#  t   #      #
#      #      #
#             #
#FFFFFF### ####
#      #      #
# t  t #  @   #
#      #      #
###############
8,7,START
10,10,TOKENDOOR,5