10,10
#,#, ,#,#,#,#,#,#,#
#, , , , ,#,#,#,#,#
#,#,#,#, , , , ,#,#
#, , , , , ,#,#,#,#
#, ,#,#,#, ,#,#,#,#
#, ,#,#,#, ,#,#,#,#
#, ,#,#,#, ,#,#,#,#
 , , , , , ,#,#,#,#
#,#,#,#,#, ,#,#,#,#
#,#,#,#,#,#,#,#,#,#
"player",1,1
"goal",7,2
"colDoor",6,2,"red"
"key",5,8,"red"
"wallEnemy",1,5,"up"
"teleporter",2,0,0,7
"teleporter",0,7,2,0